   ###########################################
   #        #  #        #  #  #     #        #
#  #######  #  ####  ####  #  #  ####  #######
#        #        #        #  #     #     #  #
####  ##########  #  ####  #  #  #######  #  #
#     #  #  #     #     #  #     #  #        #
#  ####  #  #  #  #  #######  #  #  #######  #
#        #     #        #  #  #  #           #
#  ####  #  ####  #  ####  #  #######  ####  #
#  #     #     #  #        #              #  #
#  #######  ##########  #  #  ##########  ####
#  #     #  #  #        #  #  #  #           #
#  #  #######  #  ##########  #  ####  #  #  #
#  #  #                 #     #  #     #  #  #
#  #  ####  #  #######  #  #  #  ####  #  ####
#           #        #     #  #     #  #     #
#  #  ####  #######  #  #######  #  ####  ####
#  #     #  #        #           #  #        #
#  #############  ####  #  #######  #  #  #  #
#     #              #  #  #        #  #  #  
###########################################