  #############
  #           #
# # ######### #
#       #   # #
# ##### ### # #
#   # # # #   #
##### # # # ###
#     # #   # #
### ### # ### #
#   #   #     #
# ### # ##### #
# # # # #   # #
# # ##### # # #
#         #   =
###############