   #############
               #
####  ####  #  #
#        #  #  #
#  #######  ####
#     #        #
#  ##########  #
#           #  #
#  ####  #  ####
#     #  #     =
################
