   ###################
            #        #
#######  ##########  #
#        #     #     #
#######  #  #######  #
#     #        #     #
####  ####  #######  #
#  #  #  #           #
#  #  #  #  ##########
#     #              #
#  #  #######  ####  #
#  #     #  #     #  #
#  ####  #  #  #######
#  #                 =
######################